Engineer 工程
PE: Products Engineer; 生a工程 Process engineer 制程工程
TE: Test Engineer y工程
ME: Manufacturing Engineer; u造工程; Mechanical Engineer C械工程
IE: Industrial Engineer 工I工程
DCC: Document Control Center 文管中心
BOM: Bill OF Material 材料清
ECN: Engineering Change Notice 工程庸告
TECN: Temporary Engineering Change Notice 工程Rr庸告
ATY: Assembly Test Yield Total Yield 直通率
TPM: Total Productivity Maintenance
PM: Product Manager; Project Manager
ECR: Engineering Change Request 工程更申
ECO: Engineering Change order 工程更指令
EN: Engineering Notice 工程通
WPS: Work Procedure Sheet 工作f明
ICT: In Circuit Test 路y
P/R: pilot run; C/R control run T/R trial run 做
EVT: engineer Verification Test 工程^y
DVT: Design Verification Test OCy
MVT: Mass Verification Test 多Cy
ORT: On Going Reliability Test 出信性y
S/W:software 件
H/W: hardware 硬件
DCN: Design Change Notice O更通知
PVT: Production Verification Test 生aCy
MTF: Modulation Transfer Function {整DQ功能
CAT: Carriage Alignment Tool d器{整具
ID: Industrial Design 工IO(外^O)
PCBA: Printed Circuit Board Assembly 路板Mb
F/T: Function Test 功能y
CCD: Charge Coupled Device 呙杵髦x器
ERS: External Reference Spec 外部格
PMP: Production Management Plan 工程管理

QA Quality Assurance |量保C
QRA uality & Reliability Assurance|量c可靠性保C
MQA :Manufacturing Quality Assurance u造|量保C
DQA: Design Quality Assurance O|量保C
QC: Quality Control |量控制
IQC: Incoming Quality Control 收益|量控制
VQC: Vendor Quality Control 售|量控制
IPQC: In Process Quality Control 制程|量控制
OQA: Out going Quality Control 出|量控制
QE: Quality Engineer |量工程
AQL: Acceptable Quality Level 可接受的|量水平
DPPM: Defective Pieces Per Million units 百f件中有p件
PPM: Pieces Per Million 百f分之一
CS: Custom Service 客服
MRB: Marerial Review Board
DMR Defective Material Report 材料缺陷蟾
RMA: Return Marerial Administration 材料回收理
Life Test 勖y
T/C: Temperature Cycle 囟妊h
H/T: High Temperature Test 高y
L/T: Low Temperature Test 低y
ISO: International Standard Organization H驶M
SPC: Statistic process control y^程控制
5S: 整理.整D.清理.清.素B
VMI: Visual Mechanical Inspection 外^Cz
MIL-STD: Military Standard 美
SPEC: Specification 格
AVL: Approval Vendor List 合格S商
QVL: Qualified Vendor List 合格S商
FQC: Final Quality Control 最K|量控制
OBA: Open Box Audit 成品z
EAR: Engineering Analysis Request
FAI: First Article Inspection 首件z
VQM: Vendor Quality Management S商|量管理
CAR: Corrective Action Request 改MΣ咭求
4M: Man; Machine; Material; Method 人,C,材,方法
5M: Man; Machine; Material; Method; Mwasurment 人,C,材,方法,y量
MTBF: Mean Time Between Failure 平均勖
TTL: Total

FIN Finance&Accounting 张c~目
P&L: Profit & Lose
PV : Performance Variance F象差
3 Element of Cost = M,L,O
M: Material 材料
L: Labor 人力
Overhead 管理M用
Fix OH Fix Overhead 固定管理M用
Var OH Variable Overhead 不定管理M用
COGS Cost Of Goods Sold 工Su造成本
AR: Account Receivable 收
AP: Account Payable 支

MIS Management Information System Y迅管理系y
IS: Information System Y迅系y
IT: Information Technology 系y技g
MRP: Material Requisition Plan 材料需求
I2:Information Integration System Y迅整合系y
SAP: System Application Programming 系y申目
ERP: Enterprise Resource Programming 企IY源目

HR Human Resource 人力Y源
PR: Public relation 公共PS
T/O: Turn Over Rate=Monthly T/O Total People*12
GR: General Affair 


Organization M
HQ Head Quarter 公司
Chairmen 主席 Lite-On Group 光集F
President裁
Executive Vice President 常崭笨裁
Vice President 副裁
HR Human Resource 人力Y源部
FIN Finance 
Sales N售
R&D: Research & Developing 研l部
QA: |量保C QA DQA CS
MIS: Management Information System Y迅管理系y
PUR 褓 Purchasing
IMD: Image Management Division 影像管理事I部
ITS: Information Technology System X部
QRA: Quality Reliability Assurance 品保部
MFG: Manufacturing u造部
PMC: Production & Material Control 生(a)物(料)管(理)

Materials 材料
PC: Production Control 生a控制
MPS: Mass Production Schedule 量a
FGI: Finished goods Inventory 成品存
UTS: Units To Stock 存卧
WIP: Working In Process Inventory 在制品
C/T: Cycle Time 循hrg,瓶i
WD: Working Days 工作天
MTD: Month To Days 月初到今日(例如表整理)
YTD: Year To Days年初到今日
SO: Sales Order N售清
MO: Manufacture Order u造清
BTO: Build To Order 紊a
P/N: Part Number 料
MC: Material Control 材料控制
MRP: Material Requisition Plan 材料需求
INV: Inventory 存清
Inv Turn Over Days=INVS/NSB X WD 齑嬷苻D天
PSI: Production Shipping Inventory A浯出
JIT: Just In Time 即r
Safety Inventory 安全存量
CKD: Completed Kits Delivery 全件Mb出
SKD: Semi Kits Delivery 半件(小件)Mb出
W/H: Warehouse }
Rec: Receiving Center 接收中心
Raw MTL 原物料
F/G: finish goods 成品
Import/Export M出口
SI: Shipping Instruction l指令
PL: Packing List 包b清
Inv: Shipping Invoice 出l票
ETD: Estimate Arrive A估x_rg
BL: Bill of Landing 提(海\)
AWB: Air Way Bill 提(空\)
MAWA: Master Air Way Bill 主提
HAWB: House Air Way Bill 副提
TEU: Twenty foot Equipment Unit(Contain) 二十英尺
FEU: Forty foot Equipment Unit(Contain) 四十英尺
CY: Container Yard 
THC: Terminal Handing Charge a^M
ORC: Original Receiving Charge a^M
PUR: Purchasing 褓
FOB: Free on Board \至甲板(x岸r)
CIF: Cost Insurance Freight 成本+\M+保U
OA: Open Account _
TT: Telegram Transfer R
COD: Cash On Delivery
CRP: Cost Reduction Program 降低成本方案
PR: Purchasing Requisition 褓申
PO: Purchasing Order 褓

MFG Manufacturing Production u造生a
DL: Director Labor 直接人工
IDL: Indirect Labor g接人工
DLH: Direct Labor Hours 直接工r
Productivity=UTS/DLH
PPH: Pieces Per Hour 每小r件
Efficiency=Actual/Target
DT: Machine Down Time 停Crg
AI: Auto Insertion 自硬迦
MI: Manual Insertion 人工插入
SMD: Surface Mount Device 表面粘著零件
SMT: Surface mount technology 表面粘著技g
B/I: Burn In(for how many hours at how many degree) C
WI: Work Instruction 工作f明
SOP: Standard Operation Procedure 作I指
R/I: Run In \DC器
ESD: Electrical Static Discharge o放
MP: Mass Production 量a

